***************************************
***************S***********************
* * * * * * * *     * * *     *       * 
* * *** * * * *** *** * * ********* ***
* * *   * * *     *   * *   *     *   *   
* * * *** ******* ***** * ******* *** * 
* * *     *   *   *     * *     * * * * 
* ***** * * * *** * ***** ***** * * * *
* *     * * * *     * *     *         *
* ***** * *** * ***** *********** *****
*     * * * *             *   *     * * 
* * * *** * *** * ***** ***** ******* *
* * *   * * *   *     * *             *    
* ***** * * *********** ******* *** * *
* *     *   *   *     * *   *   * * * *     
* * * ********* * ***** * *** *** *** *
* * *       *           *   * * *   * *  
* ******* ***** ******* * *** * * *** *
*   *   *   *   *   *     *         * *
* ***** * *** ***** * ******* * ***** * 
*     *           *     *     * * *   * 
*** *** ********************* *** *** *
*   *   *     *               * * *   *
*** *** * ***** * ******* *** * * *** *
*       *       *   *   * * *   *     *
*** ***** ***** *** *** *** ***** * * *
*       *   *   * * *       *   * * * *  
*** *** * ***** * ***** *** *** *** ***
*   *     *   *   *     * * * *     * *
* ***** *** ***** ******* * * *** *** *
*   *                 *           *   * 
*************************E*************
***************************************