***************************************
***************S***********************
* * * * * * * * +   * * *     *       * 
* * *** * * * ***+*** * * ********* ***
* * *   * * *    +*   * *   *     *   *   
* * * *** *******+***** * ******* *** * 
* * *     *   *  +*     * *     * * * * 
* ***** * * * ***+* ***** ***** * * * *
* *     * * * * +   * *     *         *
* ***** * *** *+***** *********** *****
*     * * * *   + +++++   *   *     * * 
* * * *** * *** *+*****+***** ******* *
* * *   * * *   *     *+*       +++ + *    
* ***** * * ***********+*******+***+*+*
* *     *   *   *     *+*   * + * * *+*     
* * * ********* * *****+* ***+*** ***+*
* * *       *   +++++++ *   *+* *   *+*  
* ******* *****+******* * ***+* * ***+*
*   *   *   * + *   *     * +       *+*
* ***** * ***+***** * *******+* *****+* 
*     * +++++     *     *   + * * * + * 
*** ***+*********************+*** ***+*
*   *  +*     * + +++++++ +++ * * * + *
*** ***+* *****+*+*******+*** * * ***+*
*   +++ * +++++ *   *   * * *   *   + *
***+*****+***** *** *** *** ***** *+* *
*   +++ * + *   * * *       *   * *+* *  
*** ***+*+***** * ***** *** *** ***+***
*   *   + *   *   *     * * * *   + * *
* ***** *** ***** ******* * * ***+*** *
*   *                 *   +++++++ *   * 
*************************E*************
***************************************
