***************
*           E *
*   ******    *
*        *    *
*     S  *    *
*   ******    *
*             *
*************** 