***************
*   ++++++++E *
*  +******    *
*   ++   *    *
*     S  *    *
*   ******    *
*             *
*************** 
