*************************+*************************
*                        +++++++    * *           *
* * *** *** *******************+***** * * * * * ***
* * *   * *   *   * * *    +++++        * * * *   *
***** * * *** * *** * * ***+*** * ***** *** *******
*     * *   * *     *   * *+*   *     * * *       *
*** ******* * ***** *** * *+******* * *** * *** * *
* *     *     *   *     *  +  *     * *       * * *
* * *********** * *********+* ******* * *** * *****
*     * *   * * *     *  +++* *   *   * *   *     *
* ***** * *** * ***** ***+*** * * * ******* ***** *
* *     *   * * *       *+* *   * * * *   *     * *
* * ***** *** *** *** ***+* ***** *** *** ***** ***
*     *   * * *     * *  +    * *       * *     * *
* * ***** * * * *** * ***+***** *** ***** *** * * *
* * *           *   * *+++*     *     *     * *   *
* ******* ******* * ***+******* *** * * ********* *
*   *       *     * *+++*         * * * *     *   *
*** * * ***** * *****+******* ******* * * * * * ***
*     *   *   *+++++++  *       * *   * * * * *   *
*** * *** * ***+***** ******* * * * *** *** * *** *
* * * * * * * *+++  * * *     *       *   * * * * *
* * *** * * * ***+*** * * ********* ***** * * * * *
* * *   * * *    +*   * *   *     *   *     * * * *
* * * *** *******+***** * ******* *** * *** *** * *
* * *     *   *  +*     * *     * * * *   *   * * *
* ***** * * * ***+* ***** ***** * * * ***** * * * *
* *     * * * *+++  * *     *           * * *   * *
* ***** * *** *+***** *********** ******* * * * * *
*     * * * *  +++++++++  *   *     * * *   * * * *
* * * *** * *** * *****+***** ******* * *** * * * *
* * *   * * *   *     *+*      +++++++*     * * * *
* ***** * * ***********+*******+*** *+******* * * *
* *     *   *   *     *+*   *+++* * *+      * *   *
* * * ********* * *****+* ***+*** ***+* ***** * ***
* * *       *  +++++++++*   *+* *   *+*   *   *   *
* ******* *****+******* * ***+* * ***+*** * *******
*   *   *   *+++*   *     *  +      *+* * * * * * *
* ***** * ***+***** * *******+* *****+* *** * * * *
*     *+++++++    *     *    +* * *  +*   *     * *
*** ***+*********************+*** ***+*** *** * * *
*   *  +*     *+++++++++++++++* * *  +*       *   *
*** ***+* *****+* ******* *** * * ***+* *** ***** *
*  +++++*+++++++*   *   * * *   *  +++*   * *   * *
***+*****+***** *** *** *** ***** *+* *** *** * * *
*  +++++*+  *   * * *       *   * *+*   * *   *   *
*** ***+*+***** * ***** *** *** ***+*** ******* ***
*   *  +++*   *   *     * * * *  +++* * *     *   *
* ***** *** ***** ******* * * ***+*** * *** ***** *
*   *                 *  +++++++++*         *     *
*************************+*************************