***************************************************
*************************S*************************
*                         +++++     * *           *
* * *** *** *******************+***** * * * * * ***
* * *   * *   *   * * *     +++         * * * *   *
***** * * *** * *** * * ***+*** * ***** *** *******
*     * *   * *     *   * *+*   *     * * *       *
*** ******* * ***** *** * *+******* * *** * *** * *
* *     *     *   *     * +   *     * *       * * *
* * *********** * *********+* ******* * *** * *****
*     * *   * * *     *   + * *   *   * *   *     *
* ***** * *** * ***** ***+*** * * * ******* ***** *
* *     *   * * *       *+* *   * * * *   *     * *
* * ***** *** *** *** ***+* ***** *** *** ***** ***
*     *   * * *     * *  +    * *       * *     * *
* * ***** * * * *** * ***+***** *** ***** *** * * *
* * *           *   * * + *     *     *     * *   *
* ******* ******* * ***+******* *** * * ********* *
*   *       *     * * + *         * * * *     *   *
*** * * ***** * *****+******* ******* * * * * * ***
*     *   *   * +++++   *       * *   * * * * *   *
*** * *** * ***+***** ******* * * * *** *** * *** *
* * * * * * * * +   * * *     *       *   * * * * *
* * *** * * * ***+*** * * ********* ***** * * * * *
* * *   * * *    +*   * *   *     *   *     * * * *
* * * *** *******+***** * ******* *** * *** *** * *
* * *     *   *  +*     * *     * * * *   *   * * *
* ***** * * * ***+* ***** ***** * * * ***** * * * *
* *     * * * * +   * *     *           * * *   * *
* ***** * *** *+***** *********** ******* * * * * *
*     * * * *   + +++++   *   *     * * *   * * * *
* * * *** * *** *+*****+***** ******* * *** * * * *
* * *   * * *   *     *+*       +++ + *     * * * *
* ***** * * ***********+*******+***+*+******* * * *
* *     *   *   *     *+*   * + * * *+      * *   *
* * * ********* * *****+* ***+*** ***+* ***** * ***
* * *       *   +++++++ *   *+* *   *+*   *   *   *
* ******* *****+******* * ***+* * ***+*** * *******
*   *   *   * + *   *     * +       *+* * * * * * *
* ***** * ***+***** * *******+* *****+* *** * * * *
*     * +++++     *     *   + * * * + *   *     * *
*** ***+*********************+*** ***+*** *** * * *
*   *  +*     * + +++++++ +++ * * * + *       *   *
*** ***+* *****+*+*******+*** * * ***+* *** ***** *
*   +++ * +++++ *   *   * * *   *   + *   * *   * *
***+*****+***** *** *** *** ***** *+* *** *** * * *
*   +++ * + *   * * *       *   * *+*   * *   *   *
*** ***+*+***** * ***** *** *** ***+*** ******* ***
*   *   + *   *   *     * * * *   + * * *     *   *
* ***** *** ***** ******* * * ***+*** * *** ***** *
*   *                 *   +++++++ *         *     *
*************************E*************************
***************************************************
