****************
*    +    *  +E*
*   +*+   * +***
*   +* +  *  + *
*  + *  + * +  *
* +  *   +*+   *
*S   *    +    *
****************
