****************
*         *   E*
*    *    ******
*    *    *    *
*    *    *    *
*    *    *    *
*S   *         *
****************
